NO  ./img/XPM/Walls/FOREST_W.xpm
SO  ./img/XPM/Walls/FOREST_2_W.xpm
WE  ./img/XPM/Walls/GLADE_W.xpm
EA  ./img/XPM/Walls/BURNED_W.xpm

F  0,39,25
C  24,0,19

1111111111111111111111111
1000000000000000000000001
1011111111111111111111101
1000000000000000000000001
111111111011101111111111
1000000000000000000000001
1011111111111111111111101
1000000000000000000000001
1000000000000000000000001
1011111111111111111111101
1000000000000000000000001
111111111011101111111111
1000000000000000000000001
1011111111111111111111101
1000000000000000000000001
1000000000000000000000001
1011111111111111111111101
1000000000000000000000001
111111111011101111111111
1E00000000000000000000001
1111111111111111111111111
