NO  ./img/XPM/Walls/FOREST_W.xpm
SO  ./img/XPM/Walls/FOREST_2_W.xpm
EA  ./img/XPM/Walls/GLADE_W.xpm
WE  ./img/XPM/Walls/BURNED_W.xpm

F  0,39,25
C  24,0,19

111111111111111111
100000000000000001
100000000000000001
100001110111100001
100010000000010001
100010000000010001
100000000000000001
100010000000010001
1000100000C0010001
100010000000010001
100001110111100001
100000000000000001
100000000000000E01
111111111111111111
