NO  ./img/XPM/Walls/FOREST_W.xpm
SO  ./img/XPM/Walls/FOREST_2_W.xpm
WE  ./img/XPM/Walls/GLADE_W.xpm
EA  ./img/XPM/Walls/BURNED_W.xpm

F  0,39,25
C  24,0,19

1N11
1101
1111