NO  ./img/XPM/Walls/FOREST_W.xpm
SO  ./img/XPM/Walls/FOREST_2_W.xpm
WE  ./img/XPM/Walls/GLADE_W.xpm
EA  ./img/XPM/Walls/BURNED_W.xpm

F  0,39,25
C  24,0,19

111111111111111111111111111111111111111111
111000000000000010000001001000000000000111
1100001DDDDDD11000000011100000111111111111111
10000011      10000010001000001000000000001
1000000D1     11100000000100000100000001111
101111111111111000000001000001000000000001
100000000000000000000000000001111110000001
100000001111100000000N00000001110000000001
100000000000000000000000000000000000000001
111111111111111111111111111111111111111111
