NO  ./img/XPM/Walls/FOREST_W.xpm SO  ./img/XPM/Walls/FOREST_2_W.xpm WE  ./img/XPM/Walls/GLADE_W.xpm EA  ./img/XPM/Walls/BURNED_W.xpm

F  0,55,34
C  135,206,235

1111111111111111111111111111
1000000000000000000000000001
1000000000000000000000000001
1000000000000000000000000001
1000000000000000000000000001
1000000011111111111100000001
10000001            10000001
10000001            10000011
10000001            100001
10000001            10001
10000001            1001
10011001            101
10000001            10011111
10000001            10000001
10000001            10000001
1000000011111111111100000001
1000E00000000000000000000001
1000000000000000000000000001
1111111111111111111111111111