NO  ./img/XPM/Walls/FOREST_W.xpm
SO  ./img/XPM/Walls/FOREST_2_W.xpm
WE  ./img/XPM/Walls/GLADE_W.xpm
EA  ./img/XPM/Walls/BURNED_W.xpm

F  0,55,34
C  135,206,235

111111111111111111111111111111111111111111
111000000000000000000001000000000000000111
11000011111111000000011100000111111111111111
1000001      10000000001000000000000000001
1000001       100000000100000000000000000111
100000111111111000000001000000000000000001
100000000000000000000000000001110000000001
100000000000000000000N00000001110000000001
100000000000000000000000000000000000000001
111111111111111111111111111111111111111111
