NO  ./img/XPM/Walls/FOREST_W.xpm
SO  ./img/XPM/Walls/FOREST_2_W.xpm
WE  ./img/XPM/Walls/GLADE_W.xpm
EA  ./img/XPM/Walls/BURNED_W.xpm

F  0,55,34
C  0,55,34

11111111
10000001
10000001
10000001
10000001
10000001
10000001
11110001
11110001
10000001
10000001
10000001
1000N001
11111111