NO  ./img/XPM/Walls/FOREST_W.xpm
SO  ./img/XPM/Walls/FOREST_2_W.xpm
WE  ./img/XPM/Walls/GLADE_W.xpm
EA  ./img/XPM/Walls/BURNED_W.xpm

F  0,39,25
C  24,0,19

1111111111111111111111
1111111000000111111111
1111111000000111111111
1111111000000111111111
1111111000000111111111
1111111000000111111111
1111111000000111111111
1111111000000111111111
11111111111D1111111111
1111111000000111111111
1111111000000111111111
1111111000000111111111
1111111000000111111111
1111111000000111111111
1111111000000111111111
1111111000000111111111
1111111000000111111111
1111111100011111111111
1111111100011111111111
1111111100011111111111
111111111D111111111111
1111111100011111111111
1111111111D1111111111
1111111000000111111111
1111111000000111111111
1111111000000111111111
1111111000000111111111
1111111000000111111111
1111111000000111111111
1111111000000111111111
1111111000000111111111
1111111100011111111111
1111111100011111111111
1111111100011111111111
111111111D111111111111
1111111100011111111111
1111111100011111111111
1111111111D1111111111
1111111000000111111111
1111111000000111111111
1111111000000111111111
1111111000000111111111
1111111000000111111111
1111111000000111111111
1111111000000111111111
1111111000000111111111
1111111100011111111111
1111111100011111111111
1111111100011111111111
111111111D111111111111
1111111100011111111111
1111111100011111111111
111111111D1111111111
1111111000000111111111
1111111000000111111111
1111111000000111111111
1111111000000111111111
1111111000000111111111
1111111000000111111111
1111111000000111111111
1111111000000111111111
1111111100011111111111
1111111100011111111111
1111111100011111111111
111111111D111111111111
1111111100011111111111
1111111100011111111111
1111111100011111111111
1111111100011111111111
1111111100011111111111
1111111100011111111111
1111111100011111111111
1111111100011111111111
1111111100011111111111
1111111100011111111111
1111111100011111111111
1111111100011111111111
1111111100011111111111
1111111100011111111111
1111111000000111111111
11111110NC000111111111
1111111000000111111111
1111111000000111111111
1111111000000111111111
1111111000000111111111
1111111111111111111111